15
15
###############
#             #
#        $    #
#  &          #
#           D #
#      #$#    #
#   a     %   #
#             #
#             #
#      *      #
#             #
#      *      #
#  *     $    #
#          $  #
###############