17
21
#####################
#IKKKKKKKK#KKKKKKKKI#
#K##K####K#K####K##K#
#K##KKKKKKKKKKKKK##K#
#KKKKK#K#####K#KKKKK#
#K###K#KKK# KK#K###K#
#KKK#K###K#K###K#KKK#
###K#K#KKKKKKK#K#K###
###K#KKK # # KKK#K###
#KKKKK#K#%TG#K#KKKKK#
#K###K#K#####K#K###K#
#*KK#KKKKKWKKKKK#KKK#
###K#K#K#####K#K#K###
#KKKKK#KKK#KKK#KKKKK#
#K#######K#K ######K#
#IKKKKKKKKKKKKKKKKKI#
#####################
