17
21
#####################
# III T    #  *   T #
# II ####           #
#       II          #
#     #   #   #     #
#  ## #  I#II   ### #
#   # ## I#I  # #   #
##  # #       # # ###
##       # ##   # ###
#     # #%  # # *   #
#        #### # ### #
#KKK K   K@     #   #
###K K K  ### # # ###
#KK KK#   #   #     #
#K####### #  ###### #
#KKKKKKKKKKK        #
#####################
