17
21
#####################
#KKKKKKKKKKKKKKTKKKK#
#KKKKKKKKKKKKKKKKKKK#
#K%KKKKKKKKKKKKKKKKK#
#KKKKKKKKKKKKKKKKKKK#
#KKKKKKKKKKKKKKKKKKK#
#KKKKKKKKKKKKKKKKKKK#
#KKKKKKKKKKKKKKKKKKK#
####              ###
#          @        #
####              ###
#KKKKKKKKKKKKKKKKKKK#
#KKKKGKKKKKKKKKKKKGK#
#KKKKKKKKKKKKKKKKKKK#
#KKKKKKKK*KKKKKKKKKK#
#KKKKKKKKKKKK%KKKKKK#
#####################