17
21
#####################
#                   #
#                   #
#      #####        #
#      #   #        #
#   &   D ##        #
#                   #
#              a    #
#                   #
#      %            #
#                   #
#                   #
#                   #
#                   #
#             *     #
#                   #
#####################
